####################################################################################################################################################################################
###########..............#...##.....##......##.........##......#....#####################.........#....#.........#......######............######...........###...##................#
###########+####.#######...#....###.#..####..#.#######....####.#.##.##...###............#.#######...##...#######...##.#.######.##########....###.#########...#.#.##.####+#########.#
####...........#..###...###########...######...###############...##.#..#..##............#.###########################.#.######.###########.#..#..###########...#....##...........#.#
####...........##..#..#.#####...##################################....###.##............#...#####....################.#.######.##########..##.#.######################...........#.#
####...........###.#.##..####.#........###########################.######..#............###..####.##.################.#.#....#.#########..#...#.######################...........#.#
####...........#...#.###.####.########.###########################.#######.#............####..##..#..################.#.#....+.#########.#..###..##########........###...........#.#
####...........#.###..#..####..#.....#..############.........#####.#####...#............+...#....#..#################.#.#....###########.#.#####..#########........###...........#.#
####...........#....#.#.######.+.....##.############.........####..###...###............#.#.#####..##################.#.#....###########.#..#####.#########........###############.#
####...........####.#.#.######.#.....#..############.........+..#.###..#####............#.#.......###################.#.#....###########..#..###..#########........###############.#
####...........####...#.#####..#######.#############.........##.#.###.######............#..########################...#.#################..#...#.##########........###############.#
####...........#######..###...###....#..############.........##.#.###.######............##.#######################..###.####....##########..##.#.##########........###############.#
####...........###.....####.#####.##..#..##......###.........##.#..#..######............##..#################...#..####..###.##..##########.#..#.##########........###############.#
####...........###.########..####..##.##.##......##############.##.#.######################..##############...#.#.######.###..##.##########.#.#..##########........###############.#
####...........#...##...####..####.##.#..##......#....###...##..##.#..#####.........##....##.##############.###...######..###..#..#...####..#.#.##################+###############.#
####...........#.###..#.#####.####..#...#.+......#.##.###.#.##.###.##.#####.#######....##.#..##...#########.########....#..###.##...#..###.#..#.########...#######.###############.#
####...........#.###.##..####....##.####..########..#..#..#..#.###.##..####.#############...#...#.########..#.....#..##..#..##...#####.###.#.##..#######.#..######.############....#
################.###.###.#######..#.#....#####....#..#...###...###.###....#.#########...#####.###..#######.##.....#.####..#.####.####..#...#.###...#####.##..####..###########..##.#
################.###.###.########.#.#.##.......##.##.############..######.#..##...###.#.#####.####.#######.##.....#..####.#.####.###..##.###.#####..###..###.###..############.#...#
################..##.###..#######.#...###########.##..###########.###.....##.##.#.###.#.#####.####....####..+.....##.####...####.#...#...#...######..#..###...#..#############.#.###
#################.##.####.#######..######.......#..##.###########.#...######....#.....#.#####.#######.#####.#.....##.##########..#.###.##..#########...####.#...##############.#.###
#################....####.########..#####.#####..#.##.###########.#.###....############..###..###.....#####.########..########..##.....#..#################+##################.#...#
#######################...#########.#####..#####.#..#..##########.#...#.##..####...#####.###.##...#########...#.....#.########.########..###########...##.......##############.###.#
##################....#.###########.#...##.#####..#..#..#########..##.#.###.####...##....###..#+#############...###.#.########.#.....##.##########...#.##.......##############.#...#
##################....#...#########.#...+..######.##..#.....######.##.#.###..###...#..#######.#.........###########.#....#####.#.....##..####...#..###..#.......##############.#.###
##################....###.#########.#...#.#######..##.#####.######..#...####..##...#.#######..#.........##########..####..##...#.....###......#...#####.#.......#####...###....#.###
##################....###..########.#####.########....#####.#######..########.##...#.######..##.........##########.#...##..#.###.....########+#########.#.......#####.#.....####...#
##################....####.######...#####..################.########.######...##...#..###...###.........#########..#.#.###.#...#.....####.............#.#############..#####....##.#
##################....###..###....########..######...####...#######..##.....####...##..#..#.###.........#########.#..#.....###.+.....####.............#..##...########.##....##..#.#
##################....##..#....############.##.....#..#...#########.#...########...###.#.#..###.........#########.#.#########..#.....####.............##.#..#.########.#..######...#
##################....#..#..#####.........#.#..######...###########.#.###...####...###...#.####.........#######...#..#######..##.....##################..#.##..#######.#.####...####
##################....#.#..######.........#...#####################.#.....#..###...#######...##.........######..####.#######.###.....##........#...#....#..###..######.#.####.#.####
###############..+....#.#.#######.........###########...##########..#+######..##...###....##.##.........####...###...#######..##.....#..######...#...###..#####.####...#..###.#.####
###############.##....#...#######.........##########..#.#########..##.....###.##...+.#.##....##.........####.#####.##....####..#.....#.###...##########..######.###..####.###.#.####
###############..#....####...####.........##########.##..#...###..###.....#...##...#.#..#######.........####..##...#..##..####.#.....#.###.#..########..#######.....#####.#...#.####
################.#....###..#.####.........##########...#...#..##.####.....#.####...#..#.#######.........#####.#..##..####...#..#.....#.###.##.########.###############....#.###..###
################.######...##...#######+###############..#####.##...##.....#.#########...#####################.#.#...#######...########.#...#..######...#...........##..###..####..##
################.###....######.#######.....#........###.###...####.##.....#...#...########....###############.#...###......####.....##...###.######..###...........#..####.######.##
################..##.#########.#######.###.#........#....#..######..#.....###.#.#.#######..##.########...####.#######.####..##..###...###....#####..####...........#.#...#.######..#
#################..#.#.....###..#####..#...#........+.##.#.########.#.....#...#.#.######..#...########.#.####.##......#...#....######.....#######..#####...........#...#.#..######.#
##############...#.#.#.###....#.#####.##.###........####.#.#####....#######.##..#..###...#..##########.#..##..##.#####..#.#####...########...####.######...........#####..#.#####..#
##############.#...#.#..#####...#####.#..###........###..#.####..######...#.##.###.###.##..###########..#.##.###.......#..###...#...#####..#.####..###.+...........#...##...####..##
#############..####..##.#...#########.#.####........###.##..##..#...#...#...##..#..###..#.#############.#..#.##########..####.#####.####..##.#####.###.#...........#.#..######...###
#############.#####.###...#..#...#....#....#........###.###..#.##.#...#########.#.#####.#.############..##.#..#......#..#####.##....####.###..####.##..#...........#..#.#....#.#####
#############..####..#######.#.#.#.#######.###########..####.#..#..###...#...##.#..####.#...###...####.#...##.#.####...#####..#..#######....#..###.#..###############.#...##...#####
##############..####.#######.#.#.#..######..########...#####.##.##..##.#...#..#..#..#...###..##.#.###..#.##...#...##########.#..###########.##.###.#.####.....#.....#.##############
###############.###..#######...#..#.#######...#####..#######....###.##..#####.##.##.#.######.#..#.###.#..#..#####.###...###..#.#######...##.##.#...#......###.#.###.#.##############
###############.#...#############.#.#########..###..###############.###.#####..#.##...######...##..##.#.#..######..#..#.#...##.##...#..#..#.##...############...###...##############
###############...###############...##########.....################.....######...#################....#...########...##...####....#...###...########################################
####################################################################################################################################################################################
