####################################################################################################################################################################################
####################################################################################################################################################################################
####################################################################################################################################################################################
####################################################################################################################################################################################
####################################################################################################################################################################################
####################################################################################################################################################################################
####################################################################################################################################################################################
####################################################################################################################################################################################
####################################################################################################################################################################################
####################################################################################################################################################################################
####################################################################################################################################################################################
#############################################............###............................#...#...####################################################################################
#############################################.##########.....##########################.#.#.#.#.####################################################################################
#############################################...........#####.........................#.#.#.#.#.####################################################################################
#######################################################.......#######################.#.#.#.#.#.####################################################################################
#############################################..........#######........................#.#.#.#.#.####################################################################################
#############################################.########.........########################.#.#.#.#.####################################################################################
#############################################.........#########.......................#.#.#.#.#.####################################################################################
#####################################################...........#####################.#.#.#.#.#.####################################################################################
#############################################........###########......................#.#.#.#.#.####################################################################################
#############################################.######.............######################.#.#.#.#.####################################################################################
#############################################.......#############.....................#.#.#.#.#..####.............##################################################################
###################################################...............###################.#.#.#.#..#..###.............##################################################################
#############################################......###############....................#.#.#..#..#.###.............##################################################################
#############################################.####.................####################.#..#..#.#.###.............##################################################################
#############################################.....#################...................#..#..#.#.#.###.............##################################################################
#################################################...................#################..#..#.#.#.#.###.............##################################################################
#############################################....###################.................#..#.#.#.#.#.###.............##################################################################
#############################################.##.....................###############..#.#.#.#.#.#.###.............##################################################################
#############################################...#####################.............###...#.#.#.#.#.###.............##################################################################
###############################################.......................###########+#######.#.#.#.#.###.............##################################################################
#######################################################################..............####.#.#.#.#.###.............##################################################################
#######################################################################..............####.#.#.#.#.###.............##################################################################
#######################################################################..............####.#.#.#.#.#.+.............##################################################################
#######################################################################..............####.#.#.#.#.#.################################################################################
#######################################################################..............####.#.#.#.#.#.............####################################################################
#######################################################################..............####.#.#.#.#.#############.####################################################################
#######################################################################..............####.#.#.#.#.#...#...#...#.####################################################################
#######################################################################..............####.#.#.#.#.#.#.#.#.#.#.#.####################################################################
#######################################################################..............####.#.#.#.#.#.#.#.#.#.#.#.####################################################################
#######################################################################..............####...#...#...#...#...#...####################################################################
#######################################################################..............###############################################################################################
#######################################################################..............###############################################################################################
#######################################################################..............###############################################################################################
#######################################################################..............###############################################################################################
####################################################################################################################################################################################
####################################################################################################################################################################################
####################################################################################################################################################################################
####################################################################################################################################################################################
####################################################################################################################################################################################
