####################################################################################################################################################################################
#....##########......................#####.........................................................................................................................................#
#....#........#......................#...#..############.................................................................................###############...........................#
#....#........#......................#...#..#..........#................................#######..........................................#.............#...........................#
#....##########......................#...#..#..........#................................#.....#..........................................#.............#.........####..............#
#....................................#...#..#..........#................................#.....#..........................................#.............#.........#..#..............#
##########...........................#...#..#..........#........########................#######......##########.################.........#.............#.........#..#..............#
##.......#...........................#...#..#..........#........#......#............#####............#........#.#..............#.........#.............#.........#..#..............#
##.......#.......##############......#...#..#..........#........#......#............#...#............#........#.#..............#.........###############.........#..#..............#
##.......#.......#............#......#...#..#..........#........#......#............#...#..###########........#.#..............#.................................#..#..............#
##.......#.......#............#......#...#..#..........#........#......#............#####..#........##........#.################.................................#..#..............#
##.......#.......#............#......#####..#..........#........#......#...................#........##........#.............................##################...####..............#
##.......#.......#............#.............#..........#........#......############........###########........#.........#################...#................#.....................#
##.......#.......#............#.............#..........#........#......##.........#..................#........#.........#...............#...#................#.....................#
##.......#.......#............#.............############........#......##.........#..................##########.........#...............#...#................#.............######..#
##########.......#............#.................................#......##.........#.....................................#...............#...#................#.............#....#..#
#................#............#.................................#......##.........#.....................................#...............#...#................#.............#....#..#
#................##############.................................#......##.........#.....................................#################...##################.............#....#..#
#...............................................................#......##.........#..........................############..................................................#....#..#
#..................................................############.#......##.........#..........................#..........#..................................................#....#..#
#..................................................#..........#.#......##.........#..........................#..........#..................................................######..#
#..................................................#..........#.#########.........#..........................#..........#..........................................................#
#......................................####........############.........#.........#.........##############...#..........#..........................................................#
#........#######.......................#..#.............................#.........#.........#............#...#..........#..........###########.....................................#
#........#.....#.......................#..#....##############...........#.........#.........#.##########.#...#..........#..........#.........#.....................................#
#........#.....#.......................#..#....#............#...........#.........#.........#.#........#.#...#..........#..........#.........#.################....................#
#...####.#.....#.......................#..#....#............#...........#.........#.........#.#........#.#...#..........#..........#.........#.#..............#....................#
#...#..#.#.....#.......................#..#....#............#...........###########.........#.#........#.#...############..........#.........#.#..............#...##########.......#
#...#..#.#######.......................#..#....#............#...............................#.#........#.#.........................#.........#.#..............#...#........#.......#
#...#..#.....................########..#..#....#............#........................#####..#.#........#.#.........................#.........#.#..............#...#........#.......#
#...#..#.....................#......#..####....#............#........................#...#..#.#........#.#.........................#.........#.#..............#...#........#.......#
#...#..#.....................#......#..........#............#........................#...#..#.#........#.#.........................#.........#.#..............#...#........#.......#
#...#..#.....................#......#..........#............#........................#...#..#.#........#.#...############..........#.........#.#..............#...#........#.......#
#...#..#.....................#......#..........#............#..............######....#...#..#.##########.#...#..........#..........#.........#.#..............#...#........#.......#
#...#..#.....................########..........#............#..............#....#....#...#..##############...#..........#..........#.........#.################...#........#.......#
#...#..#.......................................##############..............#....#....#####...................############..........#.........#....................#........#.......#
#...#..#................###########........................................#....#..................................................#.........#.#########..........#........#.......#
#...####................#.........#........................................#....#............#######...........######..............###########.#.......#..........#........#.......#
#.......########........#.....#####........................................#....#....#########.....#...........#....#....############..........#.......#..........##########.......#
#.......#......#........#.....#..##........................................#....#....#......##.....#...........#....#....#..........#..........#.......#...........................#
#.......#......#........#.....#..##........................................#....#....#......##.....#...........#....#....#..........#..........#.......#......############.........#
#.......#......#........#.....#..##........................................#....#....#......########...........######....#..........#..........#########......#..........#.........#
#.......#......#........#.....#..##........................................#....#....#......#............................#..........#.........................#..........#.........#
#.......########........#.....#..##........................................#....#....#......#............................#..........#.........................#..........#.........#
#.......................#.....#..##........................................#....#....#......#............................#..........#.........................############.........#
#.......................#.....#####........................................######....#......#............................#..........#..............................................#
#.......................###########..................................................#......#............................############..............................................#
#....................................................................................########......................................................................................#
#..................................................................................................................................................................................#
####################################################################################################################################################################################
